B B B B B B  B    B    B    B    B    B    B     B     B   B   B   B    B    B   B   B   B   B   B   B   B  B B B B B
B B B B B B  B    B    B    B    B    B    B     B     B   B   B   B    B    B   B   B   B   B   B   B   B  B B B B B
B B B B B B  B    B    B    B    B    B    B     B     B   B   B   B    B    B   B   B   B   B   B   B   B  B B B B B
B B B B B C1 W7   W7   W7   W7   W7   W7   W7    W7    C2  B   C1  W7   W7   W7  W7  W7  W7  W7  W7  W7  C2 B B B B B
B B B B B W5 BW14 BW15 BW15 BW15 BW15 BW15 BW2   BW3   W4  B   W5  BN1  BW2  BW2 BW2 BW2 BW2 BW2 BW2 BW3 W4 B B B B B
B B B B B C3 W2   W2   W2   W2   W2   W3   WN2_1 WN2_2 W4  B   W5  BN2  BW10 BW8 BW8 BW8 BW8 BW8 BW8 BW9 W4 B B B B B
B B B B B B  B    B    B    B    B    W5   WN2_3 WN2_4 W4  B   W5  BN3  BW6  W1  W2  W2  W2  W2  W2  W2  C4 B B B B B
B B B B B B  B    C1   W7   W7   W7   W8   BW4   BW6   W6  W7  W8  BW4  BW6  W4  B   B   B   B   B   B   B  B B B B B
B B B B B B  B    W5   BW1  BW2  BN1  BW2  BW13  BW12  BW2 BW2 BW2 P3   BW6  W4  B   B   B   B   B   B   B  B B B B B
B B B B B B  B    W5   BW7  BW8  BN4  BW8  BW8   BW8   BW8 BW8 BW8 BW8  BW6  W4  B   B   B   B   B   B   B  B B B B B
B B B B B B  B    C3   W2   W2   W2   W2   W2    W2    W2  W2  W2  W3   BW17 W4  B   B   B   B   B   B   B  B B B B B
B B B B B B  B    B    B    B    B    B    B     B     B   B   B   C3   W2   C4  B   B   B   B   B   B   B  B B B B B
B B B B B B  B    B    B    B    B    B    B     B     B   B   B   B    B    B   B   B   B   B   B   B   B  B B B B B
B B B B B B  B    B    B    B    B    B    B     B     B   B   B   B    B    B   B   B   B   B   B   B   B  B B B B B
B B B B B B  B    B    B    B    B    B    B     B     B   B   B   B    B    B   B   B   B   B   B   B   B  B B B B B
B B B B B B  B    B    B    B    B    B    B     B     B   B   B   B    B    B   B   B   B   B   B   B   B  B B B B B
