B B B B B B B B B B  B   B   B   B   B   B   B   B   B   B   B  B B B B B B B B B B B
B B B B B B B B B B  B   B   B   B   B   B   B   B   B   B   B  B B B B B B B B B B B
B B B B B B B B B B  B   B   B   B   B   B   B   B   B   B   B  B B B B B B B B B B B
B B B B B B B B B C1 W7  W7  W7  W7  W7  W7  W7  W7  W7  W7  C2 B B B B B B B B B B B
B B B B B B B B B W5 BW1 BW2 BW2 BW2 BW2 BW2 BW2 BW2 BW2 BW3 W4 B B B B B B B B B B B
B B B B B B B B B W5 BW4 BW5 BW5 BW5 BW5 BW5 BW5 BW5 BW5 BW6 W4 B B B B B B B B B B B
B B B B B B B B B W5 BW4 BW5 BW5 BW5 BW5 BW5 BW5 BW5 BW5 BW6 W4 B B B B B B B B B B B
B B B B B B B B B W5 BW4 BW5 BW5 BW5 BW5 BW5 BW5 BW5 BW5 BW6 W4 B B B B B B B B B B B
B B B B B B B B B W5 BW7 BW8 BW8 BW8 BW8 BW5 BW5 BW5 BW5 BW6 W4 B B B B B B B B B B B
B B B B B B B B B C3 W2  W2  W2  W2  W3  BW4 BW5 BW5 BW5 BW6 W4 B B B B B B B B B B B
B B B B B B B B B B  B   B   B   B   W5  BW7 BW8 BW8 BW8 BW9 W4 B B B B B B B B B B B
B B B B B B B B B B  B   B   B   B   C3  W2  W2  W2  W2  W2  C4 B B B B B B B B B B B
B B B B B B B B B B  B   B   B   B   B   B   B   B   B   B   B  B B B B B B B B B B B
B B B B B B B B B B  B   B   B   B   B   B   B   B   B   B   B  B B B B B B B B B B B
B B B B B B B B B B  B   B   B   B   B   B   B   B   B   B   B  B B B B B B B B B B B
B B B B B B B B B B  B   B   B   B   B   B   B   B   B   B   B  B B B B B B B B B B B