B B B B B  B  B  B  B  B  B  B  B  B  B  B  B  B  B  B  B B   B  B  B  B  B  B  B B B B
B B B B B  B  B  B  B  B  B  B  B  B  B  B  B  B  B  B  B  B  B  B  B  B  B  B  B B B B
B B B B B  B  B  B  B  B  B  B  B  B  B  B  B  B  C1 W7 W8 W7 W7 W7 W7 W7 W7 C2 B B B B
B B B B B  B  B  B  B  B  B  B  B  B  B  B  B  B  W5 B  B  B  B  B  B  B  B  W4 B B B B
B B B B C1 W7 W7 W7 W7 W7 W7 W7 W7 W7 W7 W7 W7 W7 W8 B  B  B  B  B  B  B  B  W5 B B B B
B B B B W5 B  B  B  B  B  B  B  B  B  B  B  B  B  B  B  B  B  B  B  B  B  B  W4 B B B B
B B B B W5 B  B  B  B  B  B  B  B  B  B  B  B  B  B  B  B  B  B  B  B  B  B  W4 B B B B
B B B B W5 B  B  B  B  B  B  B  B  B  B  B  B  B  B  B  B  B  B  B  B  B  B  W4 B B B B
B B B B W5 B  B  B  B  B  B  B  B  B  B  B  B  B  B  B  B  B  B  B  B  B  B  W4 B B B B
B B B B W5 B  B  B  B  B  B  B  B  B  B  W1 W2 W2 W2 W2 W2 W2 W2 W2 W2 W2 W2 C4 B B B B
B B B B W5 B  B  B  B  B  B  B  B  B  B  W4 B  B  B  B  B  B  B  B  B  B  B  B  B B B B
B B B B C3 W2 W2 W2 W2 W3 B  B  B  B  B  W4 B  B  B  B  B  B  B  B  B  B  B  B  B B B B
B B B B B  B  B  B  B  W5 B  B  B  B  B  W4 B  B  B  B  B  B  B  B  B  B  B  B  B B B B
B B B B B  B  B  B  B  C3 W2 W2 W2 W2 W2 C4 B  B  B  B  B  B  B  B  B  B  B  B  B B B B
B B B B B  B  B  B  B  B  B  B  B  B  B  B  B  B  B  B  B  B  B  B  B  B  B  B  B B B B
B B B B B  B  B  B  B  B  B  B  B  B  B  B  B  B  B  B  B  B  B  B  B  B  B  B  B B B B
